# Level 1 - Museum Main Hall
# 0: Floor
# 1: Wall
# Grid size: 25x19 cells (800x600 pixels with 32px cells)

# Top and bottom borders
1111111111111111111111111
1000000000000000000000001
1000000000000000000000001
1000011111000011111000001
1000011111000011111000001
1000011111000011111000001
1000000000000000000000001
1000000000000000000000001
1000000001111111000000001
1000000001111111000000001
1000000001111111000000001
1000000000000000000000001
1000000000000000000000001
1000011111000011111000001
1000011111000011111000001
1000011111000011111000001
1000000000000000000000001
1000000000000000000000001
1111111111111111111111111
